
 ##  #####  ###@
 #####   ####
 #       #
 ###     ####
 #  ######  #
 #          #
 ######$#####   
