
 #####################          
 #           ###  #  ## #####
 #########    #   #  #      #
 #       #    #   #  ########
 #   ##  #        #  #      #
 #  ###  #    #   #  #      #
 #  ######   ######  #      ##
 #  $    ##   #  #   #       ##
 #    ####    #  #   #      ##
 #            #  #   #       ###
 #############################
